254  254  254  254  254  254  254  254  254  254  254  254  254  254  254  254  254  254  254  254  254  254  254  254  254  254  254  254  254  254  254  254  254  254  254  254  254  254  254  254  254  254  254  254  254  254  254  254  254  254  254  254  254  254  254  254  254  254  254  254  254  254  254  254  
 254  254  254  254  254  254  254  254  254  254  254  254  254  254  254  254  254  254  254  254  254  254  254  254  254  254  254  254  254  254  254  254  254  254  254  254  254  254  254  254  254  254  254  254  254  254  254  254  254  254  254  254  254  254  254  254  254  254  254  254  254  254  254  254  
 254  254  254  254  254  254  254  254  254  254  254  254  254  254  254  254  254  254  254  254  254  254  254  254  254  254  254  254  254  254  254  254  254  254  254  254  254  254  254  254  254  254  254  254  254  254  254  254  254  254  254  254  254  254  254  254  254  254  254  254  254  254  254  254  
 254  254  254  254  254  254  254  254  254  254  254  254  254  254  254  254  254  254  254  254  254  254  254  254  254  254  254  254  254  254  254  254  254  254  254  254  254  254  254  254  254  254  254  254  254  254  254  254  254  254  254  254  254  254  254  254  254  254  254  254  254  254  254  254  
  57   37   38   38   25  159  254  254  254  254  254  254  254  213  119   43   38   36   60  141  237  254  254  254  254  254  254  254  254  254  254  254  169   91   33   38   38   31  160  254  254  254  254  254  254  254  254  247  185   75   39   38   38   88  178  254  254  254  254  254  254  254  254  254  
  20    0    0    0    0  139  254  254  254  254  254  189   39    0    0    0    0    0    0    0    0  101  239  254  254  254  254  254  254  254  143    8    0    0    0    0    0    0  140  254  254  254  254  254  254  253  135    2    0    0    0    0    0    0    0    8  160  254  254  254  254  254  254  254  
  22    0    0    0    0  142  254  254  254  254  152    1    0    0    0    0    0    0    0    0    0    0   23  219  254  254  254  254  253   98    0    0    0    0    0    0    0    0  143  254  254  254  254  254  251   55    0    0    0    0    0    0    0    0    0    0    0   91  252  254  254  254  254  254  
  22    0    0    0    0  142  254  254  254  170    0    0    0    0    0    0    0    0    0    0    0    0    0   16  245  254  254  254  114    0    0    0    0    0    0    0    0    0  142  254  254  254  254  253   77    0    0    0    0    0    0    0    0    0    0    0    0    0  104  254  254  254  254  254  
  22    0    0    0    0  142  254  254  233    7    0    0    0    0    0    8   33   27    0    0    0    0    0    0   90  254  254  207    0    0    0    0    0    0    5   33   31    0  143  254  254  254  254  152    0    0    0    0    0    0   19   36   15    0    0    0    0    0    2  189  254  254  254  254  
  22    0    0    0    0  142  254  254  121    0    0    0    0    0   34  223  254  253  156    1    0    0    0    0    4  214  254   90    0    0    0    0    0   46  216  254  254  209  228  254  254  254  250   19    0    0    0    0    0  125  246  254  237   75    0    0    0    0    0   62  254  254  254  254  
  22    0    0    0    0  142  254  247   36    0    0    0    0   23  232  254  254  254  254  151    0    0    0    0    0  126  247   31    0    0    0    0   33  240  254  254  254  254  254  254  254  254  182    0    0    0    0    0   91  254  254  254  254  252   53    0    0    0    0    3  236  254  254  254  
  22    0    0    0    0  142  254  242   20    0    0    0    0  100  254  254  254  254  254  236   23    0    0    0    0  109  236   16    0    0    0    0  123  254  229  106   95   98   96   96  221  254  159    0    0    0    0    3  201  254  254  254  254  254  171    0    0    0    0    1  215  254  254  254  
  22    0    0    0    0  142  254  233   11    0    0    0    0  160  254  254  254  254  254  251   49    0    0    0    0   90  235   16    0    0    0    0  148  254  211    6    0    0    0    0   29  251  136    0    0    0    0   25  229  254  254  254  254  254  217    0    0    0    0    0  193  254  254  254  
  22    0    0    0    0  142  254  241   19    0    0    0    0   86  254  254  254  254  254  231   19    0    0    0    0  106  243   27    0    0    0    0  134  254  214   14    0    0    0    0    0  202  167    0    0    0    0    3  194  254  254  254  254  254  157    0    0    0    0    1  214  254  254  254  
  22    0    0    0    0  152  254  252   51    0    0    0    0    6  190  254  254  254  254  100    0    0    0    0    0  143  253   56    0    0    0    0   19  229  224    4    0    0    0    0    0   99  216    0    0    0    0    0   41  254  254  254  254  237   20    0    0    0    0    6  244  254  254  254  
  21    0    0    0    0   49  244  254  142    0    0    0    0    0    8  184  254  251  102    0    0    0    0    0    7  230  254  125    0    0    0    0    0   28  180  213  149    4    0    0    0   94  254   35    0    0    0    0    0   74  226  254  210   33    0    0    0    0    0   83  254  254  254  254  
  64    0    0    0    0    0    0  111  253   34    0    0    0    0    0    0    0    0    0    0    0    0    0    0  139  254  254  250    7    0    0    0    0    0    0    0    0    0    0    0    0  156  254  194    0    0    0    0    0    0    0    0    0    0    0    0    0    0   10  225  254  254  254  254  
 124    0    0    0    0    0    0  124  254  206    8    0    0    0    0    0    0    0    0    0    0    0    0   46  250  254  254  254  169    1    0    0    0    0    0    0    0    0    0    0   14  239  254  254  122    0    0    0    0    0    0    0    0    0    0    0    0    0  143  254  254  254  254  254  
 251   35    0    0    0    0    0  124  254  254  210   20    0    0    0    0    0    0    0    0    0    0   77  249  254  254  254  254  254  162    0    0    0    0    0    0    0    0    0    1  180  254  254  254  254  115    0    0    0    0    0    0    0    0    0    0    4  157  254  254  254  254  254  254  
 254  235   26    0    0    0    0  116  254  254  254  228   90    0    0    0    0    0    0    0    4  160  253  254  254  254  254  254  254  254  198   43    0    0    0    0    0    0   23  194  254  254  254  254  254  254  191   28    0    0    0    0    0    0    0   49  212  254  254  254  254  254  254  254  
 254  254  254  204  129  110  101  180  254  254  254  254  254  248  170  119  114  112  132  197  254  254  254  254  254  254  254  254  254  254  254  254  213  131  113  114  120  196  254  254  254  254  254  254  254  254  254  254  227  137  116  114  114  154  227  254  254  254  254  254  254  254  254  254  
 254  254  254  254  254  254  254  254  254  254  254  254  254  254  254  254  254  254  254  254  254  254  254  254  254  254  254  254  254  254  254  254  254  254  254  254  254  254  254  254  254  254  254  254  254  254  254  254  254  254  254  254  254  254  254  254  254  254  254  254  254  254  254  254  
 254  254  254  254  254  254  254  254  254  254  254  254  254  254  254  254  254  254  254  254  254  254  254  254  254  254  254  254  254  254  254  254  254  254  254  254  254  254  254  254  254  254  254  254  254  254  254  254  254  254  254  254  254  254  254  254  254  254  254  254  254  254  254  254  
 242  240  242  249  253  254  254  254  254  254  254  254  254  254  254  254  254  254  254  254  254  254  254  254  254  254  254  254  254  254  254  254  254  254  254  254  254  247  250  254  254  254  254  254  254  254  254  254  254  254  254  254  254  254  254  254  254  254  254  254  254  254  254  254  
  16    0    0    0    0  130  254  254  254  254  254  254  200  101   32    0    0    0    0   48  125  244  254  254  254  254  254  254  254  254  253  168   68   14    0    0    0    0  131  254  254  254  254  254  254  254  253  148   81    6    0    0    0   14   74  171  254  254  254  254  254  254  254  254  
  22    0    0    0    0  142  254  254  254  254  252   99    0    0    0    0    0    0    0    0    0   18  172  254  254  254  254  254  254  239   46    0    0    0    0    0    0    0  143  254  254  254  254  254  254  211   40    0    0    0    0    0    0    0    0    0   63  231  254  254  254  254  254  254  
  22    0    0    0    0  142  254  254  254  250   66    0    0    0    0    0    0    0    0    0    0    0    0  149  254  254  254  254  229   20    0    0    0    0    0    0    0    0  143  254  254  254  254  254  212    2    0    0    0    0    0    0    0    0    0    0    0   17  225  254  254  254  254  254  
  22    0    0    0    0  142  254  254  254   93    0    0    0    0    0    0    0    0    0    0    0    0    0    2  201  254  254  253   48    0    0    0    0    0    0    0    0    0  140  254  254  254  254  230   23    0    0    0    0    0    0    0    0    0    0    0    0    0   39  248  254  254  254  254  
  22    0    0    0    0  142  254  254  205    0    0    0    0    0    0   63  149  130    9    0    0    0    0    0   44  254  254  160    0    0    0    0    0    0   53  149  144   53  159  254  254  254  254  102    0    0    0    0    0    0  103  160   87    0    0    0    0    0    0  148  254  254  254  254  
  22    0    0    0    0  142  254  254   75    0    0    0    0    0  122  254  254  254  246   43    0    0    0    0    0  172  253   61    0    0    0    0    0  138  254  254  254  254  254  254  254  254  226    0    0    0    0    0    1  228  254  254  254  181    4    0    0    0    0   22  252  254  254  254  
  22    0    0    0    0  142  254  243   26    0    0    0    0   42  249  254  254  254  254  190    4    0    0    0    0  114  242   21    0    0    0    0   57  252  254  254  254  254  254  254  254  254  167    0    0    0    0    0  138  254  254  254  254  254   91    0    0    0    0    2  224  254  254  254  
  22    0    0    0    0  142  254  238   14    0    0    0    0  142  254  254  254  254  254  250   39    0    0    0    0  101  236   16    0    0    0    0  148  254  210    4    0    0    0    0  142  254  148    0    0    0    0   19  223  254  254  254  254  254  206    0    0    0    0    0  205  254  254  254  
  22    0    0    0    0  142  254  237   14    0    0    0    0  147  254  254  254  254  254  251   42    0    0    0    0   99  235   15    0    0    0    0  149  254  214   13    0    0    0    0    6  243  151    0    0    0    0   21  225  254  254  254  254  254  210    0    0    0    0    0  204  254  254  254  
  22    0    0    0    0  143  254  243   26    0    0    0    0   43  249  254  254  254  254  193    4    0    0    0    0  113  251   42    0    0    0    0   94  254  216   13    0    0    0    0    0  150  180    0    0    0    0    0  141  254  254  254  254  254   95    0    0    0    0    2  223  254  254  254  
  22    0    0    0    0  151  254  254   69    0    0    0    0    0  134  254  254  254  252   49    0    0    0    0    0  166  253   62    0    0    0    0    1  186  230   12    0    0    0    0    0   98  233    0    0    0    0    0    4  239  254  254  254  193    5    0    0    0    0   17  252  254  254  254  
  31    0    0    0    0    2  120  209  209    0    0    0    0    0    0   69  162  142   10    0    0    0    0    0   41  253  254  193    0    0    0    0    0    0   82  193  140    3    0    0    0  107  254   98    0    0    0    0    0    0  112  173   96    0    0    0    0    0    0  146  254  254  254  254  
  76    0    0    0    0    0    0  115  254   83    0    0    0    0    0    0    0    0    0    0    0    0    0    1  193  254  254  253   41    0    0    0    0    0    0    0    0    0    0    0    0  184  254  225   17    0    0    0    0    0    0    0    0    0    0    0    0    0   30  246  254  254  254  254  
 180    0    0    0    0    0    0  124  254  252   64    0    0    0    0    0    0    0    0    0    0    0    0  142  254  254  254  254  240   19    0    0    0    0    0    0    0    0    0    0   58  254  254  254  214    2    0    0    0    0    0    0    0    0    0    0    0   13  221  254  254  254  254  254  
 254   85    0    0    0    0    0  124  254  254  251   86    0    0    0    0    0    0    0    0    0   10  167  254  254  254  254  254  254  233   34    0    0    0    0    0    0    0    0   20  230  254  254  254  254  201   29    0    0    0    0    0    0    0    0    0   52  228  254  254  254  254  254  254  
 254  254  139   50    0    0    0  110  254  254  254  254  194   88   23    0    0    0    0   45  113  242  254  254  254  254  254  254  254  254  253  156   55    4    0    0    0   43  131  253  254  254  254  254  254  254  253  137   68    1    0    0    0   15   68  161  254  254  254  254  254  254  254  254  
 236  234  247  229  208  218  227  240  254  254  254  254  254  254  235  208  207  206  214  246  254  254  254  254  254  254  254  254  254  254  254  254  252  220  205  207  208  225  254  254  254  254  254  254  254  254  254  254  254  218  207  207  206  226  254  254  254  254  254  254  254  254  254  254  
 254  254  254  254  254  254  254  254  254  254  254  254  254  254  254  254  254  254  254  254  254  254  254  254  254  254  254  254  254  254  254  254  254  254  254  254  254  254  254  254  254  254  254  254  254  254  254  254  254  254  254  254  254  254  254  254  254  254  254  254  254  254  254  254  
 254  254  254  254  254  254  254  254  254  254  254  254  254  254  254  254  254  254  254  254  254  254  254  254  254  254  254  254  254  254  254  254  254  254  254  254  254  254  254  254  254  254  254  254  254  254  254  254  254  254  254  254  254  254  254  254  254  254  254  254  254  254  254  254  
  16    0    0    0    0  136  254  254  254  254  254  254  197   97   34    0    0    0    0   48  119  243  254  254  254  254  254  254  254  254  253  162   66   17    0    0    0    0  132  254  254  254  254  254  254  254  253  143   78    7    0    0    0   15   72  167  254  254  254  254  254  254  254  254  
  22    0    0    0    0  142  254  254  254  254  252   93    0    0    0    0    0    0    0    0    0   14  166  254  254  254  254  254  254  236   40    0    0    0    0    0    0    0  143  254  254  254  254  254  254  206   34    0    0    0    0    0    0    0    0    0   56  227  254  254  254  254  254  254  
  22    0    0    0    0  142  254  254  254  250   63    0    0    0    0    0    0    0    0    0    0    0    0  146  254  254  254  254  228   18    0    0    0    0    0    0    0    0  143  254  254  254  254  254  209    2    0    0    0    0    0    0    0    0    0    0    0   15  223  254  254  254  254  254  
  22    0    0    0    0  142  254  254  254   88    0    0    0    0    0    0    0    0    0    0    0    0    0    2  197  254  254  253   44    0    0    0    0    0    0    0    0    0  140  254  254  254  254  228   19    0    0    0    0    0    0    0    0    0    0    0    0    0   35  247  254  254  254  254  
  22    0    0    0    0  142  254  254  204    0    0    0    0    0    0   66  155  136    9    0    0    0    0    0   42  254  254  158    0    0    0    0    0    0   56  156  150   56  160  254  254  254  254  100    0    0    0    0    0    0  107  167   92    0    0    0    0    0    0  147  254  254  254  254  
  22    0    0    0    0  142  254  253   72    0    0    0    0    0  128  254  254  254  250   46    0    0    0    0    0  169  253   60    0    0    0    0    0  144  254  254  254  254  254  254  254  254  224    0    0    0    0    0    2  233  254  254  254  187    4    0    0    0    0   20  252  254  254  254  
  22    0    0    0    0  142  254  243   26    0    0    0    0   43  249  254  254  254  254  191    4    0    0    0    0  114  241   21    0    0    0    0   58  252  254  254  254  254  254  254  254  254  166    0    0    0    0    0  139  254  254  254  254  254   93    0    0    0    0    2  223  254  254  254  
  22    0    0    0    0  142  254  237   14    0    0    0    0  144  254  254  254  254  254  251   40    0    0    0    0  100  236   16    0    0    0    0  151  254  208    3    0    0    0    0  137  254  148    0    0    0    0   20  224  254  254  254  254  254  208    0    0    0    0    0  204  254  254  254  
  22    0    0    0    0  142  254  237   14    0    0    0    0  144  254  254  254  254  254  251   40    0    0    0    0  100  235   16    0    0    0    0  148  254  214   13    0    0    0    0    6  243  152    0    0    0    0   20  224  254  254  254  254  254  208    0    0    0    0    0  204  254  254  254  
  22    0    0    0    0  143  254  243   26    0    0    0    0   43  249  254  254  254  254  191    4    0    0    0    0  113  251   42    0    0    0    0   92  254  216   13    0    0    0    0    0  148  181    0    0    0    0    0  139  254  254  254  254  254   93    0    0    0    0    2  223  254  254  254  
  21    0    0    0    0  148  254  254   72    0    0    0    0    0  127  254  254  254  250   46    0    0    0    0    0  169  253   64    0    0    0    0    1  180  230   18    0    0    0    0    0   98  235    0    0    0    0    0    2  233  254  254  254  187    4    0    0    0    0   20  252  254  254  254  
  32    0    0    0    0    1  115  206  210    0    0    0    0    0    0   66  155  135    9    0    0    0    0    0   42  254  254  195    0    0    0    0    0    0   78  185  135    3    0    0    0  108  254  100    0    0    0    0    0    0  107  167   92    0    0    0    0    0    0  147  254  254  254  254  
  77    0    0    0    0    0    0  115  254   88    0    0    0    0    0    0    0    0    0    0    0    0    0    2  197  254  254  254   45    0    0    0    0    0    0    0    0    0    0    0    0  187  254  228   20    0    0    0    0    0    0    0    0    0    0    0    0    0   35  247  254  254  254  254  
 181    0    0    0    0    0    0  124  254  252   67    0    0    0    0    0    0    0    0    0    0    0    0  146  254  254  254  254  241   21    0    0    0    0    0    0    0    0    0    0   60  254  254  254  217    2    0    0    0    0    0    0    0    0    0    0    0   15  223  254  254  254  254  254  
 254   91    0    0    0    0    0  124  254  254  252   93    0    0    0    0    0    0    0    0    0   14  173  254  254  254  254  254  254  236   40    0    0    0    0    0    0    0    0   26  233  254  254  254  254  206   34    0    0    0    0    0    0    0    0    0   58  232  254  254  254  254  254  254  
 254  254  140   48    0    0    0  109  254  254  254  254  197   92   22    0    0    0    0   45  119  243  254  254  254  254  254  254  254  254  253  161   56    3    0    0    0   41  134  254  254  254  254  254  254  254  253  143   70    0    0    0    0   13   70  167  254  254  254  254  254  254  254  254  
 254  254  254  252  237  233  232  243  254  254  254  254  254  254  246  235  233  233  237  251  254  254  254  254  254  254  254  254  254  254  254  254  253  237  233  233  235  251  254  254  254  254  254  254  254  254  254  254  254  239  234  233  233  242  254  254  254  254  254  254  254  254  254  254  
 254  254  254  254  254  254  254  254  254  254  254  254  254  254  254  254  254  254  254  254  254  254  254  254  254  254  254  254  254  254  254  254  254  254  254  254  254  254  254  254  254  254  254  254  254  254  254  254  254  254  254  254  254  254  254  254  254  254  254  254  254  254  254  254  
 254  254  254  254  254  254  254  254  254  254  254  254  254  254  254  254  254  254  254  254  254  254  254  254  254  254  254  254  254  254  254  254  254  254  254  254  254  254  254  254  254  254  254  254  254  254  254  254  254  254  254  254  254  254  254  254  254  254  254  254  254  254  254  254  
 254  254  254  254  254  254  254  254  254  254  254  254  254  254  254  254  254  254  254  254  254  254  254  254  254  254  254  254  254  254  254  254  254  254  254  254  254  254  254  254  254  254  254  254  254  254  254  254  254  254  254  254  254  254  254  254  254  254  254  254  254  254  254  254  
 254  254  254  254  254  254  254  254  254  254  254  254  254  254  254  254  254  254  254  254  254  254  254  254  254  254  254  254  254  254  254  254  254  254  254  254  254  254  254  254  254  254  254  254  254  254  254  254  254  254  254  254  254  254  254  254  254  254  254  254  254  254  254  254  
 